0.0d
1,nquad
2.0d
C
E
Emacs
Email
F
FAX
GAUSSLOG
GJQF
H
INSCC
S
URL
WWW
acm.org
ball.html
beebe
dlgtwo
dlog
dpsum
dx
eigensolution
f
gjl.h
gjqf
gjqfd
glqf
glqfd
http
i
ieee.org
ierr
ln
math.utah.edu
n
nquad
physics.utah.edu
s
sumneg
sumpos
w
www.math.utah.edu
www.physics.utah.edu
x
xxx
y
z
