0.0d
1,nquad
C
E
Emacs
Email
F
FAX
GAUSSLOG
GJQFD
H
INSCC
S
URL
WWW
acm.org
ball.html
beebe
deltax
dpsum
dw
dx
eigensolution
f
fprime
gjl.h
gjqf
gjqfd
glqf
glqfd
http
i
ieee.org
ierr
ln
math.utah.edu
n
nquad
physics.utah.edu
s
sumneg
sumpos
w
www.math.utah.edu
www.physics.utah.edu
x
xxx
z
